1000111111111111
1000000000000001
1000000000000001
1000000000000001
1000000000000001
1000000000000001
1000000000000001
1000000000000001
1000000222200001
1000000222200001
1000000222200001
1111111111111111